###################
#o...............o#
#.##.###.#.###.##.#
#.................#
#.##.#.#####.#.##.#
#....#...#...#....#
####.###.#.###.####
   #.#   G   #.#   
####.# #---# #.####
T....  #GGG#  ....T
####.# ##### #.####
   #.#       #.#   
####.###.#.###.####
#.................#
#.##.###.#.###.##.#
#.................#
#.##.#.#####.#.##.#
#....#...#...#....#
#.###.#######.###.#
#o.......P.......o#
###################
