###################
#o.......#.......o#
#.##.###.#.###.##.#
#.................#
#.##.#.#####.#.##.#
#.##.#...#...#.##.#
#....###.#.###....#
####.#   G   #.####
####.# #---# #.####
T    . #GGG# .    T
####.# ##### #.####
####.#       #.####
#....###.#.###....#
#.##.#...#...#.##.#
#.##.#.#####.#.##.#
#........P........#
###.#.##.#.##.#.###
#...#....#....#...#
#.#.####.#.####.#.#
#o...............o#
###################
