###################
#o...............o#
#.###.###.#.###.###
#.................#
#.#.#.##.#.#.##.#.#
#...#....#....#...#
###.#.##.#.##.#.###
  #.#.... ....#.#  
###.#.#-###-#.#.###
T... #.#GGG#.# ...T
###.#.#-###-#.#.###
  #.#.........#.#  
###.#.###.#.###.###
#.................#
#.##.###.###.###.##
#...#....#....#...#
###.#.##.#.##.#.###
#.................#
#.###.#######.###.#
#o.......P.......o#
###################
