###################
#o...............o#
#.#####.###.#####.#
#.................#
#.###.#.###.#.###.#
#.....#..#..#.....#
#.###.##.#.##.###.#
#.#...............#
#.#.###.###.###.#.#
T...#.... ....#...T
#.#.#.##---##.#.#.#
#.#...#GGGGG#...#.#
#.#####.###.#####.#
#.................#
#.###.###.#.###.###
#...#.....#.....#.#
###.#.###.#.###.#.#
#........P........#
#.###.#######.###.#
#o...............o#
###################
