###################
#o.#....P....#...o#
#.#.########.#.#.##
#.#.........#.#...#
#.###.###.#.#.###.#
#.....#...#.#.....#
###.#.#.###.#.###.#
#...#.#.#. .#.#...#
#.###.#.#---#.###.#
T......#GGGGG#....T
#.###.#######.###.#
#...#.........#...#
###.#.#######.#.###
#.#.#...#...#.#.#.#
#.#.###.#.###.#.#.#
#.#.....#.....#.#.#
#.#####.#.#####.#.#
#.......#.........#
#.#####.#.#####.#.#
#o.............#.o#
###################
