###################
#o.....#...#.....o#
#.###.##.#.##.###.#
#.#.........#.....#
#.#.###.#.###.#.#.#
#...#...#...#...#.#
###.#.#####.#.###.#
  #.#... ...#.#    
###.#.#-###-#.#.###
T...  #GGGGG#  ...T
###.#.#######.#.###
  #.#.........#.#  
###.#.###.###.#.###
#.....#.....#.....#
#.#.#######.#.###.#
#.#.....#.P.#...#.#
#.#####.#.###.#.#.#
#.#...........#.#.#
#.#.###.#.###.#.#.#
#o.....#...#.....o#
###################
