###################
#........#........#
#.##.###.#.###.##.#
#o##.###.#.###.##o#
#.................#
#.##.#.#####.#.##.#
#....#...#...#....#
####.###.#.###.####
   #.#       #.#   
####.# #---# #.####
T    . #GGG# .    T
####.# ##### #.####
   #.#       #.#   
####.###.#.###.####
#........#........#
#.##.###.#.###.##.#
#o.#...........#.o#
##.#.#.#####.#.#.##
#....#...#...#....#
#.########P########
###################
