###################
#o...............o#
#.##.#.#####.#.##.#
#....#.......#....#
####.#.#####.#.####
   #.#.......#.#   
####.###.#.###.####
   #.#       #.#   
####.# #---# #.####
T..... #GGG# .....T
####.# ##### #.####
   #.#       #.#   
####.###.#.###.####
#....#...#...#....#
#.##.#.#####.#.##.#
#.##.#.......#.##.#
#.................#
#.##.###.#.###.##.#
#....#...P...#....#
#o.##..........##o#
###################
